111111111111111111
100100000CCCCCCCC1
1000011111001CC101
1P0011E00000CCC1C1
111111111111111111
