111111111111111111111111111
1000000000000000000P1000001
110101010101010101011010101
110101010101010101011010101
10C0C0C0C0C0C0C0C0C0C0C0C01
111111111000111111111111111
100000000000000000000000001
1CCC1000000000001CCC1CCC1C1
1CCC1000000000001CCC1CCC1C1
1CCC1C0000E0000C1CCC1CCC1C1
111111111111111111111111111
